########
# oo p #
# ..   #
#      #
########