########
#      #
# oo p #
# ..   #
#      #
########
